; 19 x 12
0000000000000000000
1011011101110111010
0010001000100010010
0000000000100000110
1111111100000000000
